111111111111111111111111111111111111111111111111111
1TTP01A10010AAAA101001AAAA000101000010000100AA11TT1
1T1001H0A0101AAA1001000HH001011101000AA00H0000000T1
1H00N01001110000AA1110000000000000000N00010AAAH0111
1H1000011AA11000101000CCCC000000CCCCCCCC0000000N001
100001H10000AN0000000C111C00000C11111111C0000001011
1AAH000011A00001000CC111CCC00C111CCCC111C0000010001
1000000N000101000CC1110111C0N0CCCCC111CC00000000011
11001HA1010000CCC11100011C000CCC111CCC00N00A00TTTT1
11AAH00000000C1111111111C0C1111CCC00000N001000TEFT1
1010100N000000CCCCCC111CC0C111CCCCCCCC0000H100T00T1
1010000110011000000C111C0C11111111111C00000A1000001
101001010000AA1A000CCCCC0CCCCCCCCCCCC00000001AAAA11
1T000HHAAA0000000N0000000000000N00000000000001011T1
1TT0010100HHA01A10A1000AAH0010001HH01AA010000N10TT1
111111111111111111111111111111111111111111111111111
