111111111111111111111111111111111111111111111111111111111111111111
100000000N00000000000000000000001000000000000000000000000000000001
101001010010000010100100000001010111111000010101010000000000001001
101001010010000010100100000001010000101010000001010100000001001001
101001001010101000100100000001010110001101010100010101010100010101
100000000000000000000000000000000001001010101000100010010101010001
101001010010000010100100000001010000101000010011111111000101010101
101001001010101000100100000001010101010010010000000000000010101001
100000001001110000001110000000000000000110001010101010000100010101
101100000111111000101000CCCC000000CCCCCCCC000000000000000010100101
10000111000000P00000000C111C00000C11111111C00000010101010101010101
100001000011100001000CC111CCC00C111CCCC111C00000100001010001010001
1000000000001101000CC1110111C000CCCCC111CC000000000100010011100001
1100101110100000CCC11100011C000CCC111CCC00000101000000000010101001
1E11110000000000C1111111111C0C1111CCC00000001000000001010100010101
1010100101000000CCCCCC111CC0C111CCCCCCCC00000100010101010101010101
101000011000011000000C111C0C11111111111C00000110101010001010111101
101001010010000010000CCCCC0CCCCCCCCCCCC000000011000010100000001101
100000000000000000000000000000000000000000000001011111010101101001
101001010010000010100100000001010010101110100000101010101010111001
101001001010101000100100000001010010101110101110000010100011101001
110000000100000000011010101011000000000011000000101010000101010101
100000000011010101000000000000010101010101010101010101010101010001
101001010010000010100100000001010101010101010100110101010101010001
101001001010101000100100000001010001001010101000101001011000000101
100000000000000000000000000000000000000000000000000000000000000001
111111111111111111111111111111111111111111111111111111111111111111
