11111111111111111111111111111111111111111111111111111
10100101001000001010010000000101000010100001001111111
10100100101010100010010000000101010101001001000000001
10000000100111000000111000000000000000011000101010101
101100000111111000101000CCCC000000CCCCCCCC00000000001
10000111000000P00000000C111C00000C11111111C0000001011
100001000011100001000CC111CCC00C111CCCC111C0000010001
1000000000001101000CC1110111C000CCCCC111CC00000000011
1100101110100000CCC11100011C000CCC111CCC0000010100001
1111110000000000C1111111111C0C1111CCC00000001000000E1
1010100101000000CCCCCC111CC0C111CCCCCCCC0000010001011
101000011000011000000C111C0C11111111111C0000011010101
101001010010000010000CCCCC0CCCCCCCCCCCC00000001100001
10000000000000000000000000000000000000000000000101111
10100101001000001010010000000101001010111010000N10101
11111111111111111111111111111111111111111111111111111
