1111
1E01
1N01
1P01
1C01
1111
